1111111111111111111111111111111111111111111111111111111111111111111
1E0000000000000C00000C000000000001010010100100000101001000000010101
1010010100100000101001000000010101010010100100000101000000000010101
1010010100100000101001000000010100000010100000010000000010000010101
10100100101010100010010000000101000000000001000001010010000000000C1
100000000C00C0000000000000000000C10100110010000001010010000P0010101
1111111111111111111111111111111111111111111111111111111111111111111
