1111111111111111111111111111
1E00000000000A00000000000001
1110010100100000101001010101
1010010010101010001001010101
1010010010101010001001010101
1010C10010101010001001010101
1010010010101C10001001A101A1
1010010010101010001001010101
101001A010101010001001010101
101A010010101010001001010101
101001C010101010001001010101
1010010010101010001111000111
1000000000000000001P00001001
1111111111111111111111111111
